...............
...............
......#........
..##..#........
......#........
......#........
......#....F...
......#........
