H#..!#...F.
.#..F#.....
.#.........
........F..
.....#.....
##########.
....!....F.
...........
>..###.....