......#...  ...
......#...  ...
......#........
..##..#....P...
......#..C...F.
......#..C...F.
...........F...
...............
