...#############
................
................
...............#
...C...F......F#
...C...F......F#
...C...F....F..#
...............#
