#!..#!.#..#H.
#...#C....#..
#............
..P..........
........F....
#...#..#..#..
#......!.....
#.#..........