#...#..#..#H.
#...#C....#..
#............
..P..........
........F....
#...#..#..#..
#............
#.#..........